0 0 0 0 0 0 0 0 0 0 0 3 3 0 0 0 0 0 0 6 6 6 6 6 6 6 6 6 7 0 0 8 1 1 1 2 2 2 2 2 2 2
0 0 0 0 0 0 0 0 0 0 0 3 3 0 0 0 0 0 0 7 0 0 0 0 0 0 0 0 7 5 0 8 1 1 1 1 2 2 2 2 2 2
0 0 0 0 0 0 0 0 0 0 0 3 3 0 0 0 0 0 0 7 5 4 0 0 0 0 0 0 7 0 0 8 1 1 1 1 2 2 2 2 2 2
0 0 0 0 0 0 0 0 0 0 0 3 3 3 3 3 3 3 3 7 4 4 0 0 0 0 0 0 7 0 0 8 1 1 1 1 2 2 2 2 2 2
0 0 0 0 0 0 0 0 0 0 0 0 3 3 3 3 3 3 3 0 0 0 0 0 0 0 0 0 7 5 0 8 1 1 1 1 2 2 2 2 2 2
0 0 0 0 0 0 0 0 0 0 0 0 3 3 3 0 0 0 0 7 0 0 0 0 0 0 0 0 7 0 0 8 1 1 1 2 2 2 2 2 2 2
0 0 0 0 0 0 0 0 0 0 0 0 0 3 3 0 0 0 0 7 0 0 0 0 0 0 0 0 7 0 0 8 1 1 1 2 2 2 2 2 2 2
4 0 0 0 0 0 0 0 0 0 0 3 3 3 3 0 0 0 0 7 7 7 7 7 7 7 7 7 7 0 10 11 1 1 1 2 2 2 2 2 2 2 2
4 4 0 0 0 0 0 3 3 3 3 3 3 3 3 3 0 0 0 6 6 6 6 6 6 6 6 6 6 10 11 1 1 1 1 2 2 2 2 2 2 2 2
3 3 3 3 0 3 3 3 3 3 0 0 0 3 3 0 0 0 0 0 0 0 0 0 0 0 0 0 0 8 1 1 1 1 2 2 2 2 2 2 2 2
3 3 3 3 3 3 3 0 0 0 0 0 0 0 3 3 0 0 0 0 0 0 0 0 0 0 0 0 0 8 1 1 1 1 1 2 2 2 2 2 2 2
4 0 0 0 0 0 0 0 0 5 0 0 0 0 3 3 0 0 0 0 0 0 0 0 0 0 0 5 0 8 1 1 1 1 1 1 2 2 2 2 2 2
0 0 0 0 0 0 0 0 0 0 0 0 0 0 3 3 0 0 0 0 0 0 0 0 0 0 0 0 0 8 1 1 1 1 1 1 2 2 2 2 2 2
0 0 0 0 4 0 0 0 0 0 0 0 4 0 3 3 0 0 0 0 0 0 0 0 0 0 0 0 0 8 1 1 1 1 1 1 2 2 2 2 2 2
0 0 0 4 4 0 0 0 0 0 0 0 4 0 3 3 0 0 0 0 0 0 0 0 0 0 0 0 0 8 1 1 1 1 1 1 2 2 2 2 2 2
0 0 0 4 4 4 0 0 0 0 0 0 4 0 3 3 3 3 3 3 3 3 3 3 3 3 0 3 3 3 0 3 1 1 1 2 2 2 2 2 2 2
0 0 0 4 4 4 0 0 0 0 0 0 4 0 3 3 3 3 3 3 3 3 3 3 3 3 3 3 3 3 3 1 1 1 1 2 2 2 2 2 2 2
0 0 4 4 4 4 0 0 0 0 0 0 4 0 3 3 0 0 0 0 0 0 0 0 0 0 0 0 0 0 0 8 1 1 1 2 2 2 2 2 2 2
0 0 4 4 4 0 0 0 0 0 0 0 4 0 3 3 0 0 0 0 0 0 0 0 0 0 0 0 0 0 0 8 1 1 1 2 2 2 2 2 2 2
0 4 4 4 4 4 0 0 0 0 0 0 0 0 3 3 0 0 0 0 5 0 0 0 0 0 0 0 0 0 0 8 1 1 1 2 2 2 2 2 2 2
4 4 0 5 5 4 4 0 5 0 0 0 0 0 3 3 0 0 0 0 7 7 7 7 7 7 7 7 7 7 7 9 1 1 1 2 2 2 2 2 2 2
4 4 4 4 4 4 0 0 0 0 0 0 0 0 3 3 0 0 0 0 7 6 6 6 6 6 6 6 6 6 7 1 1 1 1 2 2 2 2 2 2 2
0 0 0 4 4 0 0 0 0 0 0 0 4 0 3 3 0 4 0 0 7 0 0 0 0 0 0 0 0 0 7 1 1 1 1 2 2 2 2 2 2 2
0 0 0 4 5 0 0 0 0 0 0 0 4 0 3 3 0 4 0 0 7 0 0 0 0 0 0 0 0 0 7 1 1 1 1 2 2 2 2 2 2 2
0 0 0 0 4 0 0 0 0 0 0 0 4 0 3 3 0 4 4 4 7 0 0 0 0 0 0 0 0 0 7 1 1 1 1 2 2 2 2 2 2 2
0 0 0 0 0 0 0 0 0 0 0 0 4 0 3 3 3 3 3 3 7 0 0 0 0 0 0 0 0 0 7 1 1 1 1 2 2 2 2 2 2 2
0 0 0 0 0 0 0 0 0 0 0 0 0 0 3 3 3 3 3 3 3 0 0 0 0 0 0 0 0 0 7 1 1 1 1 1 2 2 2 2 2 2
0 0 0 0 0 0 0 0 0 0 0 0 0 0 3 3 3 3 3 3 7 0 0 0 0 0 0 0 0 0 7 1 1 1 1 1 2 2 2 2 2 2
0 0 0 0 0 0 0 0 0 0 0 0 0 0 0 0 0 0 0 0 7 0 0 0 0 0 0 0 0 0 7 1 1 1 1 1 2 2 2 2 2 2
0 0 0 0 0 0 0 0 0 0 0 0 0 0 0 0 0 0 0 0 7 0 0 0 0 0 0 0 0 0 7 1 1 1 1 1 2 2 2 2 2 2
0 0 0 0 0 0 5 0 0 5 0 0 0 0 0 0 0 0 0 0 7 7 7 7 7 7 7 7 7 7 7 1 1 1 1 1 2 2 2 2 2 2
0 0 0 0 0 0 0 0 0 0 0 0 0 0 0 0 0 0 0 0 6 6 6 6 6 6 6 6 6 6 6 1 1 1 1 1 2 2 2 2 2 2
